13
0 0 0 0 0 0 0 Q 0 0 0 0 0
0 B 0 B 0 B 0 B 0 B 0 B 0
0 B 0 B 0 B 0 B 0 B 0 B 0
0 B 0 B 0 B S B 0 B 0 B 0
0 B 0 B 0 B 0 B 0 B 0 B 0
0 0 0 0 0 0 B 0 0 0 0 0 0
S 0 0 B 0 B 0 B 0 B 0 0 S
0 0 0 0 0 0 0 0 0 0 0 0 0
0 B 0 B 0 B 0 B 0 B 0 B 0
0 B 0 B 0 B 0 B 0 B 0 B 0
S S 0 0 0 0 0 0 0 0 0 S S
0 0 0 0 0 B B B 0 0 0 0 0
0 0 0 0 P B 0 B 0 0 0 0 0