13
0 0 B 0 0 B Q B 0 B 0 0 0
T B B B 0 B 0 S 0 B B 0 0
T T T 0 0 B 0 B 0 B 0 B 0
T W W W W W W W W W W 0 W
0 B 0 0 0 0 B B B 0 0 S S
0 0 B 0 0 0 B B B B 0 0 B
B B 0 B 0 0 B B B T B S S
0 0 0 S 0 S 0 T T T T 0 0
W W 0 W W W W W 0 W W W W
T T 0 B 0 B B 0 0 0 0 0 0
T T B B 0 0 B 0 S B B B 0
T S B B 0 B B B 0 B 0 0 0
0 0 0 0 0 B 0 B P 0 B 0 0