13
0 0 0 0 B B Q 0 S S S 0 0
S 0 B 0 B 0 0 0 S S S 0 0
S 0 B 0 0 0 B 0 0 0 0 0 0
B 0 B B B 0 B B 0 W W 0 W
0 0 B 0 0 0 0 0 0 W 0 0 0
B B 0 B 0 W W 0 0 W 0 B B
0 0 0 0 0 W B 0 B B 0 0 0
W W W 0 0 W 0 S 0 B 0 S 0
0 0 0 B B 0 0 0 0 0 S B B
B B B B B B B B B B B B B
0 0 0 0 B 0 0 0 B 0 B 0 T
B B 0 0 0 B B B 0 0 0 0 0
0 0 0 0 P B 0 B 0 0 0 0 0