13
0 0 0 0 0 0 Q 0 0 0 0 0 0
T T 0 0 B B B B B 0 0 T T
T 0 0 B B B B B B B 0 0 T
0 0 B B 0 B B B 0 B B 0 0
0 0 B 0 0 B B B 0 0 B 0 0
T 0 0 B B B B B B B B 0 T
T T 0 0 B 0 B B 0 B 0 T T
W W W 0 B B B B B 0 W W W
0 0 0 0 0 B B B 0 0 0 0 0
0 0 0 0 0 0 B 0 0 0 0 0 0
S S S 0 0 0 0 0 0 0 S S S
B B B 0 0 B B B 0 0 B B B
S S S S P B 0 B 0 0 S S S