13
0 0 0 0 0 0 0 Q 0 0 0 0 0
0 0 B T B 0 0 0 0 0 0 0 0
0 0 0 T 0 T S 0 0 0 0 0 0
0 T 0 0 0 0 T B 0 0 0 0 0
0 T T 0 0 T 0 T S 0 0 0 0
0 T 0 T 0 T 0 0 T B 0 0 0
0 T 0 0 T 0 0 0 T T S 0 0
0 0 T 0 0 0 0 T T T T B 0
0 0 0 T 0 0 T 0 T T T T 0
B 0 0 0 0 0 T 0 T T T T S
B B 0 0 0 0 0 T T T T T T
S B B 0 0 B B B T 0 T T T
S S B B P B 0 B T B B T T
