13
0 0 0 0 0 0 0 0 S S S T 0
0 B 0 0 0 0 0 0 S 0 0 S 0
B T B 0 0 0 B B B B 0 S 0
0 B T B 0 0 B 0 T B S S 0
0 0 B 0 T S B T 0 B 0 0 0
0 0 0 0 S 0 B S B B 0 0 0
0 0 B 0 T B S T 0 0 0 0 0
S S S T 0 B 0 0 B B 0 0 0
S 0 B B B B 0 0 B S S 0 0
S 0 0 S 0 0 0 0 0 S B B 0
T S S S 0 0 0 0 0 0 B S S
0 0 0 0 0 B B B 0 0 0 0 0
0 0 0 0 P B 0 B 0 0 0 0 0